0000000002200000000000000000000000000000
0000000000000000001100000000000000000000
0000000000000000000000000000000000000000
0000000000002200000000000000000000000000
0000000000000000000000000110000000000000
0000000000000000000000000000000000000000
0000010000000000000022000000000000000000
0000000000000000000000000000000000020000
0000000000220000000000000000000000000000
5555555555555555555555555555555555555555
4444444444444444444444444444444444444444
4444444444444444444444444444444444444444
4444444444444444444444444444444444444444